AccidentDocuments:
AccidentDocumentsID	int
DocumentID	int
IsSubmitted	bit
IsVerified	bit
SubmittedAt	datetime
EmployeeID	int
AccidentID	int
DocumentsPath	nvarchar(MAX)
Province:
ProvinceID	int
ProvinceName	nvarchar(100)
PropertyType:
PropertyTypeID	int
PropertyTypeName	nvarchar(50)
InvestigationOrganization:
InvestigationOrganizationID	int
InvestigationOrganizationName	nvarchar(100)
Employee:
EmployeeID	int
EmployeeLastName	nvarchar(50)
EmployeeFirstName	nvarchar(50)
EmployeePhoneNumber	nvarchar(20)
EmployeeAddress	nvarchar(200)
CommitteID	int
EmployeeUsername	nvarchar(50)
EmployeePassword	nvarchar(255)
CommitteID	int
Documents:
DocumentsID	int
DocumentsName	nvarchar(100)
Customer:
CustomerID	int
CustomerLastName	nvarchar(50)
CustomerFirstName	nvarchar(50)
CustomerRegisterNumber	nvarchar(20)
CustomerPhoneNumber1	nvarchar(20)
CustomerPhoneNumber2	nvarchar(20)
CommitteeID	int
CustomerAddress	nvarchar(200)
Committee:
CommitteeID	int
CommitteeName	nvarchar(100)
ProvinceID	int
CallType:
CallTypeID	int
CallTypeName	nvarchar(50)
CallTimeType:
CallTimeTypeID	int
CallTimeTypeName	nvarchar(50)
BankAccountType:
BankAccountTypeID	int
BankAccountTypeName	nvarchar(50)
Bank:
BankID	int
BankName	nvarchar(100)
Accident:
AccidentID	int
AccidentName	nvarchar(100)
AccidentLocation	nvarchar(200)
AccidentDate	date
AccidentTime	time(7)
AccidentDetails	nvarchar(MAX)
CallTimeTypeID	int
PropertyTypeID	int
ContactedInvestigator	bit
ReasonForNotContactingInvestigator	nvarchar(200)
InvestigatorName	nvarchar(100)
InvestigatorPhoneNumber	nvarchar(20)
InvestigatorOrganizationID	int
AppliedDate	date
ApplcationSignature	nvarchar(100)
OffenderName	nvarchar(100)
OffenderPhoneNumber	nvarchar(20)
OffenderRegisterNumber	nvarchar(20)
OffenderCommitteeID	int
OffenderAddress	nvarchar(200)
WitnessName	nvarchar(100)
WitnessPhoneNumber	nvarchar(20)
WitnessRegisterNumber	nvarchar(20)
WitnessCommitteeID	int
WitnessAddress	nvarchar(200)
BankAccountNumber	nvarchar(30)
BankAccountTypeID	int
BankID	int
BankAccountOwnerName	nvarchar(100)
BankAccountDetails	nvarchar(200)
CallTypeID	int
CallDate	date
CallTime	time(7)
CallEmployeeID	int
LoginDetails:
LoginID	int
LoginDate	datetime
EmployeeID	int
			
	
	
		
						